2 5 2
17 9 2
00 00 00 00 00 00 00 00 00 00 00 00 00 00 00 00 00 00 00 00 
00 00 24 24 24 24 24 24 00 00 00 00 24 24 24 24 24 24 00 00 
24 24 24 29 27 27 30 24 00 00 00 00 24 29 27 27 30 24 24 24 
24 29 27 28 40 40 23 24 00 00 00 00 24 25 40 40 13 27 30 24 
24 25 -1 -1 -1 -1 23 24 00 00 00 00 24 25 -1 -1 -1 -1 23 24 
24 25 -1 -1 -1 -1 23 24 00 00 00 00 24 25 -1 -1 -1 -1 23 24 
24 31 07 05 -1 -1 23 24 24 24 24 24 24 25 -1 -1 04 38 32 24 
24 24 24 25 -1 -1 23 29 27 30 29 27 30 25 -1 -1 23 24 24 24 
00 00 24 25 -1 -1 13 28 40 13 28 40 13 28 -1 -1 23 24 00 00 
00 00 24 25 -1 -1 -1 -1 -1 -1 -1 -1 -1 -1 -1 -1 23 24 00 00 
00 00 24 25 -1 -1 -1 -1 -1 -1 -1 -1 -1 -1 -1 -1 23 24 00 00 
00 00 24 25 42 42 04 07 05 42 42 04 07 05 42 42 23 24 00 00 
00 00 24 31 21 21 32 24 31 21 21 32 24 31 21 21 32 24 00 00 
00 00 24 24 24 24 24 24 24 24 24 24 24 24 24 24 24 24 00 00  
00 00 00 00 00 00 00 00 00 00 00 00 00 00 00 00 00 00 00 00 
0
0
